"filename", "language", "TypeScript JSX", "comment", "blank", "total"
"c:\Users\lenovo\Desktop\Prog\js\react\VocabPanda\src\app\app.tsx", "TypeScript JSX", 13, 3, 5, 21
"c:\Users\lenovo\Desktop\Prog\js\react\VocabPanda\src\app\context\dimensions.tsx", "TypeScript JSX", 0, 1, 1, 2
"c:\Users\lenovo\Desktop\Prog\js\react\VocabPanda\src\app\game\game_start_screen.tsx", "TypeScript JSX", 103, 6, 76, 185
"c:\Users\lenovo\Desktop\Prog\js\react\VocabPanda\src\app\premium\premium_checks.tsx", "TypeScript JSX", -1, 0, -1, -2
"c:\Users\lenovo\Desktop\Prog\js\react\VocabPanda\src\app\premium\upgrade_overlay.tsx", "TypeScript JSX", 7, 0, 1, 8
"c:\Users\lenovo\Desktop\Prog\js\react\VocabPanda\src\app\screens\home\hometab_stack\components\activity_content.tsx", "TypeScript JSX", 1, 0, 0, 1
"c:\Users\lenovo\Desktop\Prog\js\react\VocabPanda\src\app\screens\home\hometab_stack\search_results\results_table.tsx", "TypeScript JSX", 93, 6, 26, 125
"c:\Users\lenovo\Desktop\Prog\js\react\VocabPanda\src\app\screens\home\hometab_stack\search_results\search_results.tsx", "TypeScript JSX", 2, 0, 1, 3
"c:\Users\lenovo\Desktop\Prog\js\react\VocabPanda\src\app\screens\home\translate.tsx", "TypeScript JSX", 66, 6, 53, 125
"c:\Users\lenovo\Desktop\Prog\js\react\VocabPanda\src\app\screens\manage_projects\project_table_template.tsx", "TypeScript JSX", 92, 6, 25, 123
"c:\Users\lenovo\Desktop\Prog\js\react\VocabPanda\src\app\screens\manage_projects\project_view.tsx", "TypeScript JSX", 3, 0, 0, 3
"c:\Users\lenovo\Desktop\Prog\js\react\VocabPanda\src\app\shared\app_button.tsx", "TypeScript JSX", 5, 0, 0, 5
"c:\Users\lenovo\Desktop\Prog\js\react\VocabPanda\src\app\shared_styles\core_styles.tsx", "TypeScript JSX", 11, 0, 1, 12
"c:\Users\lenovo\Desktop\Prog\js\react\VocabPanda\src\app\storage\app_settings_storage.tsx", "TypeScript JSX", 92, 2, 46, 140
"Total", "-", 487, 30, 234, 751